....11....
...1221...
..123321..
.12333321.
1233333321
