1212121212
2121212121
1212121212
2121212121
3333333333
