....2....
...222...
..22222..
...222...
....2....
