222.......
...222....
......222.
.....222..
..222.....
